18 18 18 18 18 18 18 18 18 18 18 18 18 18 18 18 18 18 18 18 18 18 18 18 18 18 18 18 18 18 18 18 18 18 18 18 18 18 18 18 18 18 18 18 18 18 18 18 18 18
18 18 18 18 18 18 18 18 18 18 18 18 18 18 18 18 18 18 18 18 18 18 18 18 18 18 18 18 18 18 18 18 18 18 18 18 18 18 18 18 18 18 18 18 18 18 18 18 18 18
18 18 16 0 0 0 32 0 32 0 0 0 16 32 0 0 0 0 0 16 0 0 0 32 0 3 0 0 16 16 0 0 16 16 16 0 32 0 16 0 0 0 0 0 0 0 0 0 18 18
18 18 32 0 0 0 0 0 0 0 0 0 0 0 0 0 0 0 0 0 32 16 0 0 0 3 0 0 0 0 0 0 32 0 0 16 0 0 0 0 0 32 0 0 0 0 0 0 18 18
18 18 0 0 0 0 0 0 0 0 0 0 0 32 16 0 0 0 0 0 32 0 0 0 0 3 0 16 0 16 16 16 0 32 16 0 0 0 0 0 0 0 0 0 16 0 32 0 18 18
18 18 0 0 0 16 32 0 0 0 0 0 0 0 0 0 0 0 0 0 0 0 0 0 32 3 0 0 0 0 32 0 32 0 0 0 16 0 0 32 0 0 32 0 0 0 0 0 18 18
18 18 0 0 0 16 0 0 0 16 0 0 0 0 0 0 0 16 0 0 0 16 0 0 0 3 0 0 0 16 0 16 0 0 0 0 0 0 0 0 32 16 0 0 0 0 0 0 18 18
18 18 0 0 0 0 0 0 0 0 0 0 17 17 17 17 17 17 17 0 0 16 0 0 0 3 0 16 0 0 0 0 0 0 0 0 16 0 32 0 16 0 0 0 0 0 0 0 18 18
18 18 0 0 0 16 0 0 0 32 16 17 17 17 17 17 17 17 17 17 0 0 0 0 0 3 16 0 0 0 0 0 0 32 0 0 0 0 0 0 32 0 0 0 0 16 0 0 18 18
18 18 0 0 0 0 0 0 0 0 17 17 19 17 17 17 17 17 17 17 17 0 0 0 16 3 0 0 0 0 0 16 0 0 0 0 0 0 0 0 0 0 0 0 0 0 0 0 18 18
18 18 0 32 0 0 0 0 0 19 19 19 19 19 19 19 17 17 17 17 17 16 0 16 0 3 0 0 32 0 0 32 32 0 0 0 0 0 0 16 16 16 0 0 0 0 16 32 18 18
18 18 0 0 16 32 0 0 19 19 19 19 19 19 19 19 19 17 17 17 17 0 0 0 0 3 0 32 16 0 32 0 0 32 0 0 0 16 0 0 0 0 0 0 0 16 0 0 18 18
18 18 32 0 0 0 0 19 19 19 19 19 19 19 19 19 19 19 17 17 17 0 0 0 16 3 0 0 0 0 0 0 0 0 0 0 16 0 0 32 0 0 0 32 0 32 0 0 18 18
18 18 0 32 0 0 0 0 19 19 19 19 19 19 19 19 19 17 17 17 17 0 0 0 16 3 0 16 0 0 0 0 0 0 16 16 0 32 0 0 0 32 16 16 0 0 0 16 18 18
18 18 16 0 0 16 0 0 17 19 19 19 19 19 19 19 17 17 17 17 17 0 0 0 0 3 0 0 0 0 0 0 0 16 0 0 16 0 0 0 0 0 0 0 0 0 0 32 18 18
18 18 0 0 33 33 33 0 17 17 17 17 19 17 17 17 17 17 17 17 17 0 0 0 0 3 0 0 0 0 0 0 0 0 0 0 0 0 0 0 16 0 0 0 0 0 0 0 18 18
18 18 16 0 33 33 33 0 17 17 17 17 17 17 17 17 17 17 17 17 0 16 0 0 0 3 0 32 16 16 17 17 17 17 17 0 0 0 0 0 0 0 0 0 16 0 0 0 18 18
18 18 0 0 33 33 33 32 32 17 17 17 17 17 17 17 17 17 17 17 17 17 17 17 0 3 32 0 0 32 17 17 17 17 17 0 0 0 32 0 32 32 0 0 0 16 0 16 18 18
18 18 0 0 0 0 16 32 0 0 0 0 0 17 17 17 17 17 17 17 17 17 17 17 0 3 0 0 0 16 17 17 17 17 17 0 32 16 0 0 0 0 0 0 0 0 0 0 18 18
18 18 0 0 0 0 16 0 0 16 0 16 17 17 17 17 17 17 17 17 17 17 17 17 0 3 32 0 0 0 17 17 17 17 17 0 0 0 0 0 0 0 0 0 0 32 0 0 18 18
18 18 0 16 0 16 0 0 0 0 16 0 17 17 17 17 17 17 17 17 17 17 17 17 0 3 0 16 0 0 17 17 17 17 17 0 0 0 0 0 0 0 0 0 16 0 0 0 18 18
18 18 32 0 0 0 0 0 0 0 0 0 17 17 17 17 17 17 17 17 17 17 17 17 0 3 32 0 0 32 0 0 0 0 0 16 32 0 0 0 0 0 32 0 0 0 0 0 18 18
18 18 0 0 0 0 0 0 0 0 0 16 17 17 17 17 17 17 17 17 17 17 17 17 0 3 0 16 16 0 0 0 0 32 0 0 0 0 16 0 0 0 0 33 33 33 0 32 18 18
18 18 0 16 32 0 0 32 16 16 32 0 17 17 17 17 17 17 17 17 17 17 17 17 0 3 0 32 0 0 0 0 0 0 0 0 17 17 17 17 17 0 0 33 33 33 16 0 18 18
18 18 0 0 0 16 0 0 0 16 0 16 0 17 17 17 17 17 17 17 17 17 17 17 0 3 0 32 0 0 0 16 0 0 0 0 17 17 17 17 17 0 0 33 33 33 0 16 18 18
18 18 3 3 3 3 3 3 3 3 3 3 3 3 3 3 3 3 3 3 3 3 3 3 3 3 3 3 3 3 3 3 3 3 3 3 3 3 3 3 3 3 3 3 3 3 3 3 18 18
18 18 16 0 0 0 0 0 16 16 0 0 0 0 0 0 0 0 16 0 0 0 0 0 0 3 0 17 17 17 17 17 17 17 0 32 17 17 17 17 17 0 0 0 0 16 0 0 18 18
18 18 0 0 0 16 0 0 0 17 17 17 17 17 0 0 0 0 16 0 0 0 0 0 0 3 17 17 17 17 17 17 17 17 17 0 17 17 17 17 17 0 0 32 0 0 0 16 18 18
18 18 0 0 0 0 0 0 0 17 17 17 17 17 0 0 32 0 0 16 0 0 0 0 0 3 17 17 17 17 17 17 17 17 17 17 0 16 0 0 0 0 0 0 16 0 16 0 18 18
18 18 0 0 0 32 0 0 0 17 17 17 17 17 17 17 17 17 17 0 0 0 0 0 0 3 17 17 17 17 17 17 17 17 17 17 32 0 0 32 0 0 0 0 0 16 0 0 18 18
18 18 0 16 0 16 16 0 0 17 17 17 17 17 17 17 17 17 17 17 0 0 0 0 0 3 17 17 17 17 17 17 17 17 17 17 0 0 0 0 0 0 0 0 0 0 0 0 18 18
18 18 0 0 0 0 32 0 0 17 17 17 17 17 17 17 17 17 17 17 0 32 0 0 0 3 17 17 17 17 17 17 17 17 17 17 0 0 16 0 0 0 0 0 0 16 0 0 18 18
18 18 0 0 16 16 0 0 0 0 16 0 0 17 17 17 17 17 17 17 0 16 0 0 32 3 17 17 17 17 17 17 17 17 17 17 0 0 0 0 0 16 0 0 0 0 0 0 18 18
18 18 0 0 0 16 0 16 0 0 0 0 0 17 17 17 17 17 17 17 16 32 0 0 0 3 17 17 17 17 17 17 17 17 17 17 16 16 0 0 16 0 0 0 0 0 0 0 18 18
18 18 0 0 0 0 0 0 0 0 16 16 32 17 17 17 17 17 17 17 0 0 0 0 16 3 17 17 17 17 17 17 17 17 17 17 16 32 0 0 16 0 0 0 0 0 0 0 18 18
18 18 0 16 0 0 0 32 0 16 0 32 0 32 17 17 17 17 17 0 0 16 0 0 0 3 17 17 17 17 17 17 17 17 17 0 0 0 16 0 0 0 0 0 0 0 0 16 18 18
18 18 32 0 32 32 0 0 0 0 0 0 0 0 0 0 0 0 0 0 0 0 0 0 16 3 0 17 17 17 17 17 17 17 0 0 0 0 0 0 0 0 0 0 0 0 0 0 18 18
18 18 16 0 0 0 0 0 32 16 0 0 0 0 0 0 0 0 0 0 0 0 0 16 0 3 0 0 33 33 33 0 0 32 0 0 0 0 16 0 0 16 0 16 0 0 0 0 18 18
18 18 0 0 16 16 0 0 0 32 0 0 16 0 16 0 0 0 0 0 0 0 16 0 0 3 16 0 33 33 33 0 0 0 0 0 0 0 32 33 33 33 0 0 0 0 0 16 18 18
18 18 0 0 16 16 0 0 0 0 0 16 0 0 0 0 0 0 0 0 0 0 0 0 32 3 16 0 33 33 33 0 0 0 0 0 0 16 0 33 33 33 0 16 0 0 0 0 18 18
18 18 16 0 32 0 32 0 0 0 0 0 32 16 0 0 0 0 0 0 0 0 0 0 0 3 0 0 0 0 0 32 32 32 32 0 0 32 0 33 33 33 0 0 32 0 0 0 18 18
18 18 0 0 0 32 0 0 0 0 32 0 0 16 16 32 16 0 16 0 0 0 0 0 0 3 0 0 0 0 0 0 0 0 0 16 0 16 0 0 0 0 0 0 32 0 0 0 18 18
18 18 0 0 0 0 0 0 0 0 0 0 0 16 32 0 32 0 0 0 0 0 0 0 0 3 0 16 0 0 16 0 0 16 0 16 0 0 0 0 0 32 0 0 0 0 16 0 18 18
18 18 16 0 0 0 0 0 0 0 0 0 0 0 0 0 0 0 0 0 0 0 32 0 0 3 0 0 0 0 0 0 0 33 33 33 0 0 0 0 16 0 0 0 0 0 0 32 18 18
18 18 0 16 16 0 0 32 0 0 0 0 0 0 0 0 0 0 0 0 0 16 0 0 16 3 16 0 0 0 0 0 0 33 33 33 0 0 0 32 0 16 0 0 0 0 16 0 18 18
18 18 0 0 0 0 0 16 32 0 0 0 0 0 0 16 0 0 0 0 0 0 0 0 16 3 16 0 0 0 16 0 0 33 33 33 0 33 33 33 32 0 0 0 0 0 0 16 18 18
18 18 0 0 0 0 0 0 0 32 16 0 0 0 32 0 0 0 0 0 0 0 0 16 0 3 0 0 0 0 0 32 16 0 0 0 0 33 33 33 0 16 0 0 0 0 0 0 18 18
18 18 0 0 0 32 0 0 0 0 0 0 0 0 0 32 0 16 0 0 0 0 0 16 0 3 0 0 0 0 0 0 0 0 0 0 0 33 33 33 0 0 0 0 0 32 0 0 18 18
18 18 18 18 18 18 18 18 18 18 18 18 18 18 18 18 18 18 18 18 18 18 18 18 18 18 18 18 18 18 18 18 18 18 18 18 18 18 18 18 18 18 18 18 18 18 18 18 18 18
18 18 18 18 18 18 18 18 18 18 18 18 18 18 18 18 18 18 18 18 18 18 18 18 18 18 18 18 18 18 18 18 18 18 18 18 18 18 18 18 18 18 18 18 18 18 18 18 18 18
