18 18 18 18 18 18 18 18 18 18 18 18 18 18 18 18 18 18 18 18 18 18 18 18 18 18 18 18 18 18 18 18 18 18 18 18 18 18 18 18 18 18 18 18 18 18 18 18 18 18 18 18 18 18 18 18 18 18 18 18 18 18 18 18 18 18 18 18 18 18 18 18 18 18 18 18 18 18 18 18 18 18 18 18 18 18 18 18 18 18 18 18 18 18 18 18 18 18 18 18 18 18 18 18 18 18
18 18 18 18 18 18 18 18 18 18 18 18 18 18 18 18 18 18 18 18 18 18 18 18 18 18 18 18 18 18 18 18 18 18 18 18 18 18 18 18 18 18 18 18 18 18 18 18 18 18 18 18 18 18 18 18 18 18 18 18 18 18 18 18 18 18 18 18 18 18 18 18 18 18 18 18 18 18 18 18 18 18 18 18 18 18 18 18 18 18 18 18 18 18 18 18 18 18 18 18 18 18 18 18 18 18
18 18 18 18 18 18 18 18 18 18 18 18 18 18 18 18 18 18 18 18 18 18 18 18 18 18 18 18 18 18 18 18 18 18 18 18 18 18 18 18 18 18 18 18 18 18 18 18 18 18 18 18 18 18 18 18 18 18 18 18 18 18 18 18 18 18 18 18 18 18 18 18 18 18 18 18 18 18 18 18 18 18 18 18 18 18 18 18 18 18 18 18 18 18 18 18 18 18 18 18 18 18 18 18 18 18
18 18 18 28 26 26 26 26 26 26 26 26 26 26 26 26 26 26 26 26 26 26 26 26 26 26 26 26 26 26 26 26 26 26 26 26 26 26 26 26 26 26 26 26 26 26 26 26 26 26 26 26 26 26 26 26 26 26 26 26 26 26 26 26 26 26 26 26 26 26 26 26 26 26 26 26 26 26 26 26 26 26 26 26 26 26 26 26 26 26 26 26 26 26 26 26 26 26 26 26 26 26 29 18 18 18
18 18 18 24 1 1 1 1 1 1 1 1 1 1 1 1 1 1 1 1 1 1 1 1 1 1 1 1 1 1 1 1 1 1 1 1 1 1 1 1 1 1 1 16 1 1 1 1 1 1 1 1 1 1 1 1 1 1 1 1 1 1 1 1 1 1 1 1 1 1 1 1 1 1 1 1 1 1 1 1 1 1 1 1 1 1 1 1 1 1 1 1 1 1 1 1 1 1 1 1 1 1 23 18 18 18
18 18 18 24 1 1 1 1 1 1 1 1 1 1 1 1 1 1 1 1 1 1 1 1 1 1 1 1 1 1 1 1 1 1 1 1 1 1 1 1 1 1 1 1 1 1 1 1 1 1 1 1 1 1 1 1 1 1 1 2 2 2 1 1 1 1 1 1 1 1 1 1 1 1 1 1 1 1 1 1 1 1 1 1 1 1 1 1 1 1 1 1 1 1 1 1 1 1 1 1 1 1 23 18 18 18
18 18 18 24 1 1 1 16 1 2 2 2 2 2 1 1 1 1 1 1 1 1 1 1 1 1 1 1 1 1 1 1 1 1 1 2 2 1 1 1 1 1 1 1 1 1 1 1 1 1 16 1 1 1 1 1 2 2 2 2 16 1 1 1 1 1 1 1 1 1 1 1 1 1 1 1 1 1 1 1 1 1 1 1 1 1 1 1 1 1 1 1 1 1 1 1 1 1 1 1 1 1 23 18 18 18
18 18 18 24 1 1 1 1 2 2 1 1 1 16 16 1 1 1 1 1 1 1 1 1 1 1 1 1 1 1 1 1 1 1 2 2 1 1 1 1 1 1 1 1 3 3 3 3 3 3 3 3 3 3 3 1 1 1 1 1 1 1 1 1 1 1 1 1 2 1 1 1 1 1 1 1 16 16 16 16 16 16 1 1 1 1 1 1 1 1 1 1 1 1 1 1 1 1 1 1 1 1 23 18 18 18
18 18 18 24 1 1 1 2 2 1 1 1 1 1 1 1 1 1 2 2 1 16 16 1 1 1 1 1 1 1 16 16 1 1 2 1 1 1 1 1 1 3 3 3 3 3 3 3 3 3 3 3 3 3 3 1 1 1 1 1 1 1 1 1 1 16 16 2 1 1 1 1 1 1 1 16 16 1 1 1 1 1 1 1 1 1 16 1 1 1 1 16 16 1 1 1 1 1 1 1 1 1 23 18 18 18
18 18 18 24 1 1 1 2 1 1 16 1 1 1 1 1 2 2 2 1 1 1 1 1 1 1 1 2 1 1 1 1 1 2 2 1 1 1 1 1 3 3 3 3 3 3 3 3 3 3 3 3 3 3 3 1 1 1 1 16 1 2 2 2 2 2 16 2 2 2 1 1 1 1 1 1 1 1 1 1 1 1 1 1 1 1 1 1 1 1 1 16 1 1 1 16 16 1 1 1 1 1 23 18 18 18
18 18 18 24 1 1 1 2 1 1 1 1 1 1 1 1 2 2 16 1 1 1 1 1 2 1 1 2 1 1 1 1 1 2 1 1 1 1 1 3 3 3 3 3 3 3 3 3 3 3 3 3 3 3 3 1 1 1 1 16 1 1 1 1 1 1 1 1 1 1 2 2 2 1 1 1 1 1 1 1 1 1 1 1 1 1 1 1 3 1 1 1 1 1 1 1 1 1 1 1 1 1 23 18 18 18
18 18 18 24 1 1 1 2 1 1 1 1 1 1 1 1 1 16 16 1 1 1 1 16 2 2 2 2 1 1 1 1 2 2 1 1 1 1 1 3 3 3 3 3 3 3 3 3 3 3 3 3 3 1 1 1 1 1 16 16 1 1 1 1 1 1 1 1 1 1 16 1 2 2 1 1 1 1 1 1 1 1 1 1 1 1 1 1 3 1 1 1 1 1 1 1 1 1 1 1 1 1 23 18 18 18
18 18 18 24 1 1 1 2 2 1 1 1 1 16 16 1 1 1 1 1 1 1 16 16 1 1 2 2 1 1 1 1 2 2 1 1 1 1 3 3 3 3 3 3 3 3 3 3 3 3 3 1 1 1 1 1 1 1 1 1 1 1 1 1 1 1 1 1 1 1 16 16 1 1 1 1 1 1 1 1 1 1 1 1 1 1 1 1 3 3 1 1 1 1 1 1 1 1 16 1 1 1 23 18 18 18
18 18 18 24 1 1 1 1 2 1 1 1 1 1 1 1 1 1 1 1 1 1 1 16 1 1 2 2 2 2 1 1 16 16 1 1 1 1 3 3 3 3 3 3 3 3 3 3 3 3 3 1 1 2 1 1 16 16 1 1 1 1 1 1 1 1 1 1 1 1 1 1 1 1 1 1 1 1 1 1 16 1 1 1 1 3 1 1 3 3 1 1 1 16 16 1 1 1 1 1 1 1 23 18 18 18
18 18 18 24 1 1 1 1 2 1 1 1 1 1 1 1 1 1 1 1 16 1 1 1 1 2 2 1 1 2 2 1 16 16 1 1 1 1 1 1 3 3 3 3 3 3 3 3 3 3 1 1 2 2 1 16 16 1 1 1 1 2 2 2 2 16 16 1 1 1 1 1 1 1 1 1 16 16 1 1 16 1 1 1 1 3 3 3 3 1 1 1 1 1 1 1 1 1 1 1 1 1 23 18 18 18
18 18 18 24 1 1 1 1 1 1 1 1 1 1 1 3 3 3 1 1 1 1 1 1 1 1 1 1 1 1 1 1 1 2 2 1 1 1 1 1 1 1 1 1 3 3 3 3 3 3 1 1 2 2 1 1 1 1 1 2 2 2 1 1 1 1 1 1 1 1 2 1 1 1 2 1 1 1 1 1 1 1 1 1 1 3 3 3 1 1 1 1 1 1 1 1 1 1 1 1 1 1 23 18 18 18
18 18 18 24 1 1 1 1 1 2 2 16 1 1 1 3 3 3 3 1 1 1 1 1 1 1 1 1 1 1 1 1 1 1 2 1 1 1 1 1 1 1 1 1 3 3 3 3 3 3 3 1 1 2 1 1 1 1 2 2 1 1 1 1 1 1 1 1 1 1 2 2 2 2 2 1 1 1 1 1 1 1 1 1 3 3 3 1 1 1 1 1 1 1 1 1 1 1 1 1 1 1 23 18 18 18
18 18 18 24 1 1 1 1 1 1 2 16 1 1 1 1 1 3 3 3 1 1 1 1 1 16 16 16 1 1 1 1 1 1 2 2 1 1 1 1 1 1 1 1 1 3 3 3 3 3 3 3 1 1 1 1 1 16 1 1 1 1 2 1 1 1 1 1 1 1 1 1 1 1 1 1 1 1 1 1 1 1 1 3 3 3 3 1 1 1 1 1 1 1 1 1 1 1 1 1 1 1 23 18 18 18
18 18 18 24 1 1 1 1 1 1 2 2 1 1 1 1 1 3 3 3 1 3 1 1 1 1 1 1 1 1 1 1 1 1 16 16 1 1 1 1 1 1 2 1 1 1 3 3 3 3 3 3 1 1 1 1 1 16 1 1 1 1 2 1 1 1 16 16 1 1 1 2 1 1 16 16 1 1 1 1 1 1 3 3 3 3 1 1 1 1 1 1 1 1 1 16 1 1 1 1 1 1 23 18 18 18
18 18 18 24 1 1 1 1 1 1 2 1 1 1 1 1 1 1 3 3 3 3 3 3 1 1 1 1 1 1 1 1 1 1 1 16 2 2 1 1 2 1 1 1 1 1 1 1 3 3 3 3 1 1 1 1 1 1 1 1 2 2 2 1 1 1 1 16 1 1 1 2 1 1 1 1 1 1 1 1 1 3 3 3 3 3 1 1 1 1 1 1 1 1 1 1 1 1 1 1 1 1 23 18 18 18
18 18 18 24 1 1 1 1 1 1 2 1 1 1 1 1 1 1 3 3 3 3 3 3 3 1 1 1 1 1 1 1 1 1 1 1 16 16 16 2 2 2 1 1 1 1 1 1 3 3 3 3 3 3 1 1 1 1 1 1 2 2 1 1 1 1 1 1 1 1 2 2 1 1 1 1 1 3 1 1 3 3 3 3 3 3 1 1 1 1 1 1 1 1 1 1 1 1 1 1 1 1 23 18 18 18
18 18 18 24 1 1 1 1 1 1 2 2 2 1 16 1 1 3 3 3 3 3 3 3 3 3 3 3 3 3 1 1 1 1 1 1 16 16 1 1 1 1 2 2 1 1 1 1 1 1 3 3 3 3 3 1 1 1 1 1 1 2 1 2 2 1 1 2 1 2 2 1 1 1 1 1 1 3 1 3 3 3 3 3 3 2 1 2 1 2 1 2 1 2 2 1 1 1 1 1 1 1 23 18 18 18
18 18 18 24 1 1 1 1 1 1 2 2 1 1 1 1 1 1 3 3 3 3 3 3 3 3 3 3 3 3 3 3 3 1 1 1 1 1 1 1 1 1 1 2 2 1 1 1 1 1 3 3 3 3 3 3 3 1 1 2 1 1 2 2 1 1 1 2 2 1 1 1 1 1 1 1 3 3 3 3 3 3 3 1 1 1 1 1 1 1 1 16 1 1 1 1 1 1 1 1 1 1 23 18 18 18
18 18 18 24 1 1 1 1 1 2 2 1 1 1 1 1 1 1 1 3 3 3 3 3 3 3 1 1 3 3 3 3 3 3 3 3 1 1 1 1 1 1 1 1 2 16 1 1 1 1 3 3 3 3 3 3 3 1 1 2 1 1 2 1 1 1 1 1 1 1 1 1 1 1 1 3 3 3 3 3 3 1 1 1 1 1 1 1 1 1 1 16 1 1 1 1 1 1 1 1 1 1 23 18 18 18
18 18 18 24 1 1 1 1 2 2 1 1 1 1 1 1 1 1 3 1 3 3 3 1 1 1 1 1 1 3 3 3 3 3 3 3 3 3 3 1 1 1 1 1 2 16 16 1 1 1 3 3 3 3 3 3 1 1 1 2 1 2 1 1 1 1 1 1 1 1 1 1 1 1 3 3 3 3 3 3 1 2 1 1 1 1 16 1 2 1 1 1 1 1 1 1 1 1 1 1 1 1 23 18 18 18
18 18 18 24 1 1 1 2 2 1 16 1 1 1 1 1 1 1 3 3 3 3 3 1 1 1 1 1 1 1 3 3 3 3 3 3 3 3 3 3 3 1 1 1 1 2 2 1 1 1 1 3 3 3 3 3 1 1 1 2 2 1 1 1 1 1 1 16 1 1 1 1 1 3 3 3 3 3 3 1 2 2 1 1 1 16 1 1 2 2 1 1 1 1 1 1 1 1 1 1 1 1 23 18 18 18
18 18 18 24 1 1 1 2 1 1 16 1 1 1 3 3 1 1 3 3 3 3 1 1 1 1 1 1 1 1 1 1 3 3 3 3 3 3 3 3 3 3 3 1 1 1 1 1 1 1 1 1 3 3 3 3 3 1 2 2 2 1 1 1 1 1 1 16 1 1 1 1 3 3 3 3 3 3 1 1 2 1 1 1 1 1 1 1 32 32 32 32 32 32 1 1 1 1 1 1 16 1 23 18 18 18
18 18 18 24 1 1 1 2 1 1 1 1 1 1 3 3 3 1 1 3 3 3 3 1 1 1 1 16 16 1 1 1 1 1 1 1 3 3 3 3 3 3 3 3 3 1 1 1 1 1 3 3 3 3 3 3 3 1 2 1 1 1 1 1 1 1 1 1 1 1 1 1 3 3 3 3 3 1 1 1 2 2 1 1 1 1 1 32 32 35 35 35 34 32 1 1 1 1 1 1 16 1 23 18 18 18
18 18 18 24 1 1 1 2 1 1 1 1 1 1 1 1 3 3 3 3 3 3 3 1 1 16 16 16 16 16 16 16 16 16 1 1 1 1 1 3 3 3 3 3 3 3 1 1 1 3 3 3 3 3 3 3 3 3 1 1 1 1 16 16 1 1 1 1 1 1 1 3 3 3 3 3 1 1 1 1 1 1 1 1 1 1 32 32 34 34 34 34 34 32 1 1 1 1 1 1 1 1 23 18 18 18
18 18 18 24 1 1 1 2 1 1 1 1 1 1 1 1 3 3 3 3 3 3 1 1 1 16 16 16 1 16 16 1 1 16 16 16 1 1 1 1 3 3 1 3 3 3 3 3 3 3 3 3 3 3 3 3 3 3 1 1 1 1 1 1 1 1 1 1 1 1 3 3 3 3 3 1 1 1 1 1 1 1 1 2 2 2 32 34 34 34 34 34 34 32 1 1 1 1 1 1 1 1 23 18 18 18
18 18 18 24 1 1 2 2 1 1 1 1 1 16 1 1 1 3 3 3 3 3 3 1 1 16 16 1 1 1 16 16 16 1 16 16 16 1 1 1 1 3 3 3 3 3 3 3 3 3 3 3 3 3 3 3 3 1 1 1 1 2 1 1 1 1 1 3 3 3 3 3 3 1 1 1 1 1 1 1 1 2 2 2 1 2 32 17 34 34 34 34 34 32 1 1 1 1 1 1 1 1 23 18 18 18
18 18 18 24 1 1 2 1 1 1 1 1 1 16 16 1 1 1 3 3 3 1 1 1 1 16 16 1 16 1 16 1 1 1 1 16 16 16 16 16 1 1 1 3 3 3 3 3 3 3 3 3 3 3 3 3 3 1 1 2 1 1 1 1 1 3 3 3 3 3 3 3 1 1 1 1 1 1 1 1 1 1 16 1 1 32 32 17 17 34 34 34 32 32 1 1 1 1 1 1 1 1 23 18 18 18
18 18 18 24 1 1 1 1 1 1 1 1 2 1 1 1 1 1 3 3 3 3 1 1 1 1 16 1 1 1 1 1 16 16 1 1 16 16 16 16 16 16 16 1 1 1 1 1 3 3 3 3 3 3 3 3 3 3 1 1 1 1 3 3 3 3 3 3 3 3 3 3 3 1 1 1 1 1 1 1 2 16 16 1 32 32 17 17 17 17 17 32 32 2 1 1 1 1 1 1 1 1 23 18 18 18
18 18 18 24 1 1 1 1 1 1 1 1 2 1 1 1 1 1 1 3 3 3 1 1 1 1 16 16 1 1 1 1 1 1 1 1 1 16 16 1 1 1 16 16 16 16 16 1 1 1 1 1 3 3 3 3 3 3 1 3 3 3 3 3 3 3 1 1 5 5 1 1 1 1 1 2 2 2 2 2 2 1 1 1 32 17 17 17 17 17 32 32 1 2 1 1 1 1 1 1 1 1 23 18 18 18
18 18 18 24 1 1 1 1 1 1 1 1 2 1 1 1 1 1 1 3 3 3 1 1 1 16 16 16 16 1 1 2 2 16 1 1 1 1 1 16 16 16 16 1 16 16 16 16 16 1 1 1 1 3 3 3 3 3 3 3 3 3 3 3 5 1 1 1 1 1 2 1 1 1 1 2 1 2 2 1 1 1 1 32 32 17 17 17 17 17 32 1 2 2 1 1 1 1 1 1 1 1 23 18 18 18
18 18 18 24 1 1 1 1 1 1 1 1 2 16 1 1 1 1 3 3 3 3 3 1 1 16 16 16 16 1 1 16 1 16 1 2 16 2 1 1 1 1 1 16 16 1 16 1 16 16 1 1 1 3 3 3 3 3 3 3 3 3 5 1 1 1 1 1 1 1 1 1 1 1 1 2 2 2 2 1 16 1 32 32 17 17 17 17 17 17 32 2 2 1 1 1 1 1 1 1 1 1 23 18 18 18
18 18 18 24 1 1 1 1 1 1 1 1 2 1 1 1 1 3 3 3 3 3 3 1 1 16 16 16 1 1 16 16 1 1 16 16 16 1 2 2 2 16 16 1 1 16 16 16 16 16 1 1 1 1 3 3 3 3 3 3 3 5 1 1 1 16 16 16 1 1 1 1 1 1 1 2 1 1 2 2 1 32 32 17 17 17 17 17 17 32 32 1 1 1 1 1 1 1 1 1 1 1 23 18 18 18
18 18 18 24 1 1 1 1 1 1 1 2 2 1 1 1 1 3 3 3 3 1 1 1 1 1 16 16 1 1 1 1 1 1 1 1 16 1 1 1 1 2 16 2 2 1 1 16 16 16 1 1 1 1 3 3 3 3 3 3 2 2 2 1 1 1 1 1 1 1 1 1 32 32 32 32 32 32 1 2 2 32 32 17 17 17 17 17 17 32 1 1 1 1 1 1 1 1 1 1 1 1 23 18 18 18
18 18 18 24 1 1 1 1 1 1 1 2 1 1 16 16 1 1 3 3 3 3 3 1 1 1 16 16 16 1 1 1 16 1 1 1 16 16 1 1 1 1 16 1 2 1 1 16 16 16 1 1 1 1 3 3 3 3 3 3 3 3 2 2 2 2 1 3 2 1 32 32 32 17 17 17 17 32 32 32 32 32 32 17 17 17 17 17 32 32 1 1 1 1 1 1 1 1 1 1 1 1 23 18 18 18
18 18 18 24 1 1 1 1 1 1 1 2 1 1 16 16 1 1 3 3 3 3 3 1 1 1 16 16 16 1 1 1 16 16 2 2 2 2 16 16 16 1 1 2 2 1 1 16 16 16 1 1 1 1 3 3 3 3 3 3 3 3 3 3 3 3 3 3 3 2 32 17 17 17 17 17 17 17 17 17 17 17 17 17 17 17 17 32 32 1 1 1 1 1 1 1 1 1 1 1 1 1 23 18 18 18
18 18 18 24 1 1 1 1 1 1 1 16 1 1 1 1 1 1 3 3 3 3 3 3 1 1 16 16 16 1 16 1 2 16 16 1 1 1 1 1 2 2 2 2 1 1 1 16 16 16 1 1 1 3 3 3 3 2 3 3 3 3 3 3 3 3 3 3 3 3 3 17 17 17 17 17 17 17 17 17 17 17 17 17 17 17 32 32 1 2 1 1 1 1 1 1 1 1 1 1 1 1 23 18 18 18
18 18 18 24 1 1 1 1 1 1 1 1 1 3 1 1 1 1 3 3 3 3 3 1 1 1 16 16 1 1 16 2 1 16 1 1 1 1 1 2 2 2 2 1 1 1 16 1 16 1 1 1 3 3 3 3 1 1 1 1 3 3 3 3 3 3 3 3 3 3 3 17 17 17 17 17 17 17 17 17 17 17 17 17 17 17 32 2 2 2 2 2 2 2 2 1 1 1 1 1 1 1 23 18 18 18
18 18 18 24 1 1 1 1 1 1 1 1 1 3 1 1 1 1 3 3 3 3 1 1 1 16 16 16 1 1 2 2 2 2 2 2 1 1 1 16 2 2 1 1 16 1 16 16 16 1 1 3 3 3 3 3 1 1 1 2 2 2 3 3 3 3 3 3 3 1 32 17 17 17 17 17 17 17 32 32 32 17 17 32 32 32 32 2 2 2 2 2 2 1 1 1 1 1 1 1 1 1 23 18 18 18
18 18 18 24 1 1 1 1 1 2 1 1 1 3 1 1 3 3 3 3 3 3 1 1 1 16 16 16 16 1 1 1 1 1 2 16 16 16 16 16 2 1 1 1 1 1 16 16 2 2 3 3 3 3 3 3 1 2 2 16 1 1 2 2 3 3 3 1 1 1 32 32 32 17 17 17 17 32 32 2 32 32 32 32 1 1 1 1 1 2 2 2 2 2 1 1 1 1 1 1 1 1 23 18 18 18
18 18 18 24 1 1 1 1 2 16 1 1 1 3 3 3 3 3 3 3 3 3 1 1 1 16 16 16 1 1 1 16 1 2 2 2 1 16 2 1 2 16 1 1 1 16 16 16 1 1 2 1 3 3 3 3 1 2 1 1 1 2 16 1 1 1 2 2 2 1 1 1 32 32 32 32 32 32 1 1 1 1 2 1 1 1 1 1 1 1 1 16 2 2 1 1 1 1 1 1 1 1 23 18 18 18
18 18 18 24 1 1 1 1 2 1 1 1 3 3 3 3 3 3 3 3 3 1 1 1 1 16 16 16 16 1 1 16 16 16 1 1 1 1 16 1 2 16 16 1 16 16 16 1 1 1 1 3 3 3 3 3 1 2 2 1 1 2 1 1 2 2 2 2 2 2 1 1 1 1 1 1 1 1 1 1 1 1 1 2 2 2 1 1 1 1 1 1 1 16 2 1 1 1 2 1 1 2 23 18 18 18
18 18 18 24 1 1 1 1 2 1 1 1 3 3 3 3 1 3 3 1 1 1 1 1 16 16 16 16 1 1 2 2 16 16 16 16 16 16 1 2 2 1 16 16 16 16 16 16 2 2 3 3 3 3 3 3 1 1 2 2 2 2 2 2 2 1 16 1 1 1 1 1 1 1 1 1 2 1 1 1 1 1 2 2 1 1 2 1 1 1 1 1 1 1 2 2 1 1 2 2 2 2 23 18 18 18
18 18 18 24 1 1 1 1 2 1 1 1 1 3 3 3 1 1 1 1 1 1 1 1 16 16 1 1 1 16 16 1 1 1 1 1 1 16 2 2 1 1 1 16 1 1 1 16 1 1 3 3 3 3 3 1 1 1 1 1 1 2 2 2 1 1 1 1 1 1 1 1 1 1 1 2 2 1 1 1 1 1 1 2 2 1 1 1 1 1 1 1 1 1 1 2 2 1 1 1 1 2 23 18 18 18
18 18 18 24 1 1 1 1 2 1 1 16 1 1 3 3 3 3 1 1 1 1 1 1 16 1 1 1 1 16 16 1 1 1 1 1 1 2 2 16 16 1 1 1 1 1 16 16 1 1 3 3 3 3 3 1 1 1 1 1 1 1 1 2 2 1 1 1 16 1 1 1 1 1 1 2 1 1 1 1 1 1 1 1 1 16 16 16 1 2 2 2 1 1 16 1 2 2 1 1 1 2 23 18 18 18
18 18 18 24 1 1 1 1 2 1 1 16 1 1 1 3 3 3 3 1 1 1 1 16 16 1 16 1 1 2 1 1 16 16 1 1 1 1 1 2 2 2 2 16 2 1 16 16 1 1 3 3 3 3 3 1 1 1 1 1 1 1 1 1 2 2 1 1 16 1 1 1 2 1 1 1 1 16 16 1 1 1 1 1 1 1 1 1 1 1 16 1 2 2 16 1 1 1 1 1 1 2 23 18 18 18
18 18 18 24 1 1 1 1 2 1 1 1 1 1 3 3 3 3 3 1 1 1 16 16 16 16 1 1 16 2 1 16 16 1 1 1 16 16 1 1 1 1 2 16 2 2 16 16 16 1 3 3 3 3 3 3 32 32 32 32 32 32 32 1 1 2 2 1 1 16 1 1 2 1 1 1 1 1 1 1 1 1 1 1 1 1 1 1 1 1 1 1 1 1 1 1 1 1 1 1 1 1 23 18 18 18
18 18 18 24 1 1 1 1 2 1 1 1 1 1 1 3 3 3 3 3 3 1 16 16 16 16 1 1 1 2 1 1 1 1 1 1 1 1 1 1 16 1 1 1 1 2 16 16 16 3 3 3 3 3 3 1 32 34 34 34 34 34 32 1 1 1 2 2 1 1 1 1 2 1 1 1 1 1 3 3 3 3 1 1 3 3 3 1 1 1 1 1 1 1 1 1 1 2 1 1 1 1 23 18 18 18
18 18 18 24 1 1 1 1 1 1 1 1 1 1 1 3 3 3 3 3 3 3 1 16 16 16 1 1 1 2 1 1 1 2 16 2 2 16 2 1 1 16 1 1 1 2 16 16 1 1 1 3 3 3 3 1 32 34 34 34 34 34 32 1 1 1 1 2 1 1 1 1 1 1 1 1 3 3 3 3 3 3 3 3 3 3 3 3 1 1 1 1 16 1 1 1 1 2 1 1 1 1 23 18 18 18
18 18 18 24 1 1 1 1 1 1 1 16 1 1 1 1 3 3 3 3 3 1 1 16 16 16 1 1 1 16 2 2 2 2 16 2 2 2 1 1 1 1 16 1 2 2 16 16 1 1 1 3 3 3 3 1 32 34 34 34 34 34 32 1 1 1 1 2 16 1 1 1 1 1 1 3 3 3 3 3 3 3 3 3 3 3 3 3 3 3 1 1 16 1 1 1 2 16 1 1 1 1 23 18 18 18
18 18 18 24 1 1 1 1 1 1 1 2 1 1 1 1 3 3 3 3 3 1 1 1 16 16 1 1 1 1 16 2 2 1 16 16 2 2 16 1 1 1 1 2 2 16 16 1 1 1 1 3 3 3 3 1 32 34 34 34 34 34 32 1 1 1 1 2 1 16 1 1 1 1 1 3 3 3 3 3 3 17 17 17 3 3 3 3 1 1 1 1 1 1 1 2 2 16 1 1 1 1 23 18 18 18
18 18 18 24 1 1 1 1 1 1 2 2 1 1 1 1 3 3 3 1 1 1 1 1 16 1 1 1 16 1 1 1 1 2 2 16 16 1 1 16 16 16 1 2 16 16 16 1 1 1 1 3 3 3 3 1 32 34 34 34 34 34 32 1 1 1 2 2 1 1 1 1 2 1 1 3 3 3 3 3 17 17 17 17 17 3 3 3 1 1 1 1 1 1 1 1 1 1 1 1 1 1 23 18 18 18
18 18 18 24 1 1 1 1 1 2 2 1 1 1 1 1 1 3 3 3 1 1 1 1 16 16 1 1 16 16 1 1 1 16 1 1 1 1 1 16 1 16 16 2 16 16 16 1 1 2 3 3 3 3 1 1 32 32 32 0 32 32 32 1 1 1 2 2 1 16 1 1 2 2 1 1 3 3 3 17 17 17 17 17 17 3 3 3 3 1 1 1 1 1 1 1 1 1 1 1 1 1 23 18 18 18
18 18 18 24 1 1 1 1 1 2 1 1 1 16 1 1 1 1 3 3 3 1 1 16 16 16 1 1 2 16 2 1 1 2 1 1 1 1 1 16 2 2 2 16 16 16 16 1 1 2 3 3 3 3 1 1 1 1 1 1 1 1 1 1 1 1 1 2 1 16 1 1 1 1 1 1 3 3 3 3 17 17 17 17 17 3 3 3 3 1 1 1 1 1 16 1 1 1 1 1 1 1 23 18 18 18
18 18 18 24 1 1 1 1 1 1 1 1 1 1 1 1 1 1 3 3 3 1 1 16 16 16 1 1 2 2 2 2 2 2 2 1 1 16 16 1 1 1 1 16 16 16 16 1 1 1 3 3 3 3 1 1 1 1 1 1 1 1 1 1 1 1 2 2 1 1 1 1 1 1 1 1 1 3 3 3 17 17 17 17 17 3 3 3 1 1 1 16 1 1 16 1 1 1 1 1 1 1 23 18 18 18
18 18 18 24 1 1 1 1 1 1 1 1 1 1 1 1 1 3 3 3 3 3 1 1 16 16 1 1 2 2 2 16 16 2 2 2 16 16 1 1 1 1 1 16 16 1 1 1 1 1 3 3 3 1 1 1 1 1 1 1 1 1 1 2 2 2 2 1 1 1 1 1 1 1 1 1 1 3 3 3 17 17 3 17 3 3 3 3 3 1 1 1 1 1 1 1 1 1 1 1 1 1 23 18 18 18
18 18 18 24 1 1 1 1 1 1 1 1 1 1 1 1 1 3 3 3 3 3 1 1 16 16 16 1 1 1 1 2 1 1 16 2 2 1 16 1 1 1 1 16 16 16 1 1 1 1 3 3 3 2 2 2 2 2 2 2 2 2 2 2 2 2 2 1 1 1 1 1 1 1 1 1 1 1 1 3 3 3 3 3 3 3 3 3 1 1 1 1 1 1 1 1 1 16 16 1 1 1 23 18 18 18
18 18 18 24 1 1 1 1 1 1 2 2 1 1 1 1 1 3 3 3 3 3 3 1 1 16 16 1 1 1 16 2 2 1 16 2 2 2 16 1 1 16 1 16 16 1 1 1 1 3 3 3 3 1 1 1 1 1 1 1 1 16 1 1 1 2 2 2 2 2 1 1 1 1 1 1 2 1 1 1 3 3 3 3 3 3 1 1 1 1 1 1 16 1 1 1 1 1 1 1 1 1 23 18 18 18
18 18 18 24 1 1 1 1 1 2 2 2 1 1 16 1 1 3 3 3 3 3 3 1 1 1 16 16 16 1 16 1 2 1 1 2 2 16 2 16 16 1 16 16 16 1 1 1 1 3 3 3 3 1 1 1 1 1 1 1 1 16 1 1 2 2 1 1 1 2 1 1 1 1 1 1 2 2 2 2 2 1 1 1 1 1 1 1 1 1 1 1 1 1 1 1 1 2 1 1 1 1 23 18 18 18
18 18 18 24 1 1 1 1 1 2 1 2 1 1 16 1 1 1 3 3 3 3 3 3 1 1 16 16 1 16 1 1 2 16 2 2 2 16 16 16 1 1 16 16 16 1 1 1 1 3 3 3 1 1 1 1 1 1 1 1 1 1 1 1 1 2 1 1 2 2 1 1 1 16 1 1 1 1 1 1 1 1 1 1 3 1 1 1 1 1 1 1 1 1 1 1 1 2 2 1 1 2 23 18 18 18
18 18 18 24 1 1 1 1 1 1 1 2 1 1 16 1 1 1 3 3 3 3 3 1 1 1 1 16 16 16 1 1 1 2 2 16 1 1 2 1 1 1 16 16 1 1 1 1 3 3 3 3 1 1 1 1 1 1 1 1 1 1 1 1 1 2 2 2 1 1 1 1 1 1 1 1 1 1 1 1 1 1 1 3 3 3 1 1 1 3 1 1 1 1 1 1 1 1 2 2 1 1 23 18 18 18
18 18 18 24 1 1 1 1 2 2 2 2 1 1 1 1 1 1 1 3 3 3 3 3 1 1 1 1 16 16 16 1 1 1 1 16 1 2 2 1 1 1 16 16 1 1 1 3 3 3 3 3 1 1 1 1 1 1 1 1 16 1 1 1 1 2 2 1 1 1 1 1 1 1 1 1 1 1 1 1 1 1 1 3 3 3 1 3 3 3 3 1 16 1 1 1 1 1 1 2 1 2 23 18 18 18
18 18 18 24 1 1 1 1 1 1 1 1 1 1 1 1 1 1 1 1 1 3 3 3 1 1 1 1 16 16 16 1 16 1 1 16 2 2 1 1 1 1 16 16 1 1 3 3 3 3 3 1 1 1 1 1 1 1 1 1 16 1 1 1 2 2 1 1 1 16 1 1 1 1 1 1 1 1 1 1 1 1 1 1 3 3 1 3 3 3 1 1 1 1 1 1 1 1 1 2 2 2 23 18 18 18
18 18 18 24 1 1 1 1 1 1 1 1 1 1 1 1 1 1 1 1 1 3 3 3 3 1 1 1 16 16 16 1 1 1 2 16 1 1 1 1 16 16 16 16 1 1 3 3 3 3 3 1 1 1 1 1 1 1 1 1 1 1 1 1 2 1 1 1 1 1 16 16 1 1 1 1 1 1 1 3 1 2 1 1 1 1 1 3 3 3 1 1 1 1 1 1 1 2 2 1 1 1 23 18 18 18
18 18 18 24 1 1 1 1 2 2 1 1 1 1 2 1 16 1 1 1 1 3 3 3 3 3 1 1 1 16 16 1 1 2 2 1 1 16 1 16 16 16 16 1 1 1 1 3 3 3 3 1 1 1 1 1 1 1 1 1 1 1 1 2 2 1 1 1 1 1 1 1 1 1 1 1 1 1 3 3 3 2 1 1 1 1 1 1 3 1 1 3 1 1 1 1 2 2 1 1 2 1 23 18 18 18
18 18 18 24 1 1 1 2 2 1 1 1 1 2 2 2 16 1 1 1 1 3 3 3 3 3 1 1 1 16 16 16 16 1 2 2 2 1 1 16 16 1 16 1 1 1 3 3 3 3 3 1 1 1 1 1 1 1 1 1 16 16 1 2 2 1 1 1 1 1 1 1 1 1 1 1 1 1 3 3 3 2 2 2 2 2 2 1 1 1 1 3 1 1 1 1 1 2 2 2 2 2 23 18 18 18
18 18 18 24 1 1 1 2 1 1 1 1 1 2 1 2 1 1 1 1 1 3 3 3 3 1 1 1 1 16 16 16 1 1 2 1 1 1 16 1 16 16 16 1 1 1 3 3 3 3 3 1 1 1 1 1 1 1 2 2 2 16 1 1 2 2 2 1 1 1 1 1 1 1 1 1 1 1 1 3 3 3 1 1 2 16 1 1 1 1 1 3 3 1 1 1 1 1 1 2 1 2 23 18 18 18
18 18 18 24 1 1 1 2 2 1 1 1 1 2 1 2 1 1 1 1 1 1 1 3 3 3 1 1 1 16 16 16 1 1 2 1 1 1 2 16 16 16 1 1 1 1 3 3 3 3 1 1 1 1 1 1 1 2 2 1 1 1 1 1 1 1 2 2 2 1 1 1 1 1 1 1 16 1 1 1 1 1 2 2 1 1 1 1 1 3 3 3 3 3 1 1 1 1 1 2 2 1 23 18 18 18
18 18 18 24 1 1 1 1 2 2 1 1 2 1 1 2 1 1 1 1 1 1 1 3 3 3 1 1 1 16 16 16 1 1 16 16 1 1 1 1 16 16 1 1 1 1 3 3 3 3 1 1 1 1 1 1 1 1 2 2 2 2 2 1 1 1 1 1 1 2 2 2 2 1 1 1 16 1 1 1 1 1 2 1 1 1 1 1 1 3 3 3 3 1 1 1 1 1 1 1 2 2 23 18 18 18
18 18 18 24 1 1 1 1 1 2 2 2 2 1 2 2 1 1 1 16 16 1 1 3 3 3 1 1 1 16 16 16 16 1 1 2 1 1 1 1 16 1 1 1 1 1 3 3 3 3 3 3 1 1 1 1 1 1 1 1 1 1 2 2 2 1 1 2 16 2 2 2 2 2 1 1 1 1 1 1 1 1 16 16 1 1 1 1 1 3 3 3 3 3 1 1 1 1 1 1 1 2 23 18 18 18
18 18 18 24 1 1 1 1 1 1 1 1 1 16 2 1 1 1 1 1 1 1 1 3 3 1 1 1 1 1 16 16 16 1 16 2 1 1 1 16 16 16 1 1 1 1 1 3 3 3 3 1 1 1 1 1 1 1 1 1 1 1 1 2 2 1 2 2 2 2 2 2 2 1 1 1 1 1 1 1 1 1 1 1 1 1 1 1 1 1 3 3 1 1 1 1 1 1 1 1 1 2 23 18 18 18
18 18 18 24 1 1 1 1 1 1 1 1 1 16 1 1 1 1 1 1 1 3 3 3 3 3 3 1 1 1 16 16 16 1 1 1 1 16 16 16 1 1 1 1 1 1 3 3 3 3 3 1 1 1 1 1 1 1 1 1 1 1 2 2 1 1 1 1 1 1 1 1 1 1 1 1 1 1 1 1 1 1 1 3 3 3 1 1 1 1 3 3 1 1 1 1 1 1 1 1 1 2 23 18 18 18
18 18 18 24 1 1 1 1 1 1 1 1 2 1 1 1 1 1 1 3 3 3 3 3 3 3 1 1 1 1 16 16 16 16 16 16 16 16 16 16 1 1 1 1 1 1 3 3 3 3 1 1 1 1 1 1 1 1 1 2 2 2 2 1 1 1 1 1 1 1 1 1 1 2 2 2 2 2 1 1 1 1 1 3 3 3 1 1 1 1 3 3 1 1 1 1 1 1 1 1 2 2 23 18 18 18
18 18 18 24 1 1 1 1 1 1 1 2 2 1 1 1 1 3 3 3 3 3 3 3 3 3 3 1 1 1 16 16 16 16 16 16 16 16 1 1 1 1 1 1 1 1 3 3 3 1 1 1 1 2 2 2 2 2 2 2 1 1 1 1 1 1 1 1 1 1 1 2 2 1 1 1 1 2 1 1 1 1 1 3 3 3 2 1 1 1 3 3 1 1 1 1 1 1 1 1 1 1 23 18 18 18
18 18 18 24 1 1 1 1 1 1 1 2 1 1 1 1 1 3 3 3 3 3 3 3 3 3 3 1 1 1 16 16 1 1 1 1 1 1 1 1 1 3 3 1 1 1 3 3 1 1 1 2 2 2 1 1 16 1 1 1 1 1 1 1 1 1 1 1 1 1 2 2 1 1 1 1 16 2 1 1 16 1 1 1 3 3 2 1 1 1 3 3 1 1 16 16 1 1 1 1 1 1 23 18 18 18
18 18 18 24 1 1 1 1 1 1 1 2 1 1 1 1 1 1 3 3 3 3 3 3 3 3 3 1 1 1 1 1 1 1 1 1 1 1 1 1 3 3 3 1 1 3 3 1 1 1 1 1 1 1 1 1 1 1 1 1 1 1 1 1 1 1 1 1 1 1 2 1 16 1 1 1 2 1 1 1 16 16 16 1 2 2 1 1 1 1 3 3 1 1 1 1 1 1 1 1 1 2 23 18 18 18
18 18 18 24 1 1 1 1 1 1 1 2 1 1 1 1 1 1 1 3 3 3 3 3 3 3 1 1 1 1 1 1 1 1 1 1 1 3 3 3 3 3 3 3 3 3 3 3 3 1 1 1 1 1 1 1 1 1 1 16 16 1 1 1 1 1 16 16 1 1 1 1 16 1 2 2 1 1 1 1 1 16 1 2 2 1 1 1 1 3 3 1 1 1 2 2 1 1 1 1 2 2 23 18 18 18
18 18 18 24 1 1 1 1 1 1 1 2 2 2 1 1 1 1 3 3 3 3 3 3 3 3 3 3 3 3 3 1 3 3 3 3 3 3 3 3 3 3 3 3 3 3 3 3 3 1 1 1 1 1 1 1 1 1 1 1 1 1 1 1 1 1 1 1 1 1 1 1 2 2 2 1 1 16 1 1 1 16 1 1 1 1 1 1 3 3 1 1 1 1 2 1 1 1 1 2 1 1 23 18 18 18
18 18 18 24 1 1 1 1 1 1 1 1 1 2 1 1 1 3 3 3 3 3 3 3 3 3 3 3 3 3 3 3 3 3 3 3 3 3 3 3 3 3 3 3 3 3 3 3 3 3 3 3 3 3 3 1 1 1 1 1 1 1 1 1 1 1 1 1 1 1 1 2 2 1 1 1 1 16 1 1 1 1 2 2 1 1 1 3 3 3 3 1 1 1 2 2 1 1 1 1 1 1 23 18 18 18
18 18 18 24 1 1 1 1 1 1 1 1 1 16 16 1 1 1 1 1 3 3 3 3 3 3 3 3 3 3 3 3 3 3 1 3 3 3 3 3 3 3 1 1 1 3 3 3 3 3 3 3 3 3 3 3 3 1 1 1 16 16 16 1 1 1 1 1 3 3 3 2 3 1 1 1 1 1 1 1 1 1 1 1 1 1 3 3 3 3 1 1 1 1 1 16 1 1 1 1 1 1 23 18 18 18
18 18 18 24 1 1 1 1 1 1 1 1 2 2 16 1 1 1 1 1 3 3 3 3 3 3 3 3 3 3 3 1 1 1 1 1 1 3 3 3 1 1 1 1 3 3 3 3 1 1 1 1 3 3 3 3 3 3 1 1 1 1 1 1 1 1 3 3 3 3 3 3 3 1 1 3 3 1 1 1 1 1 1 1 1 3 3 3 3 3 1 1 1 1 1 16 16 1 1 2 1 1 23 18 18 18
18 18 18 24 1 1 1 1 1 1 1 1 2 1 1 1 1 1 1 1 3 3 3 3 3 3 3 3 3 3 1 1 1 1 1 1 1 1 1 1 1 1 1 3 3 3 3 1 1 1 1 1 1 1 1 3 3 3 3 1 1 1 1 1 3 3 3 3 3 3 3 3 3 3 3 3 3 3 1 1 1 1 1 3 3 3 3 3 1 1 1 1 1 1 1 2 2 2 2 1 1 1 23 18 18 18
18 18 18 24 1 1 1 1 1 1 1 1 2 2 1 1 16 16 1 1 1 1 3 3 3 3 3 3 3 1 1 1 1 1 1 1 1 1 1 1 1 1 1 1 3 3 1 1 1 1 1 1 1 1 1 1 3 3 3 3 1 1 1 3 3 3 3 3 3 3 3 3 3 3 3 3 3 3 1 1 3 1 3 3 3 3 1 1 1 1 1 1 1 1 1 1 1 1 1 1 1 1 23 18 18 18
18 18 18 24 1 1 1 1 1 1 1 1 1 2 2 1 1 16 1 1 1 1 3 3 3 3 3 1 1 1 1 1 1 1 1 1 1 1 1 1 1 1 1 3 3 3 3 1 1 1 1 1 1 1 2 2 1 1 3 3 3 3 1 3 3 3 3 3 3 3 3 3 3 3 3 3 3 3 3 3 3 3 3 3 3 1 1 1 1 1 1 1 1 2 1 1 1 1 1 1 1 1 23 18 18 18
18 18 18 24 1 1 1 1 1 1 1 1 1 1 1 2 2 1 1 1 1 1 1 1 1 1 1 1 1 1 1 1 16 16 2 2 1 1 1 1 1 1 3 3 3 3 3 1 1 1 1 16 16 2 2 2 1 1 1 3 3 3 3 3 3 3 3 3 3 3 3 3 3 3 3 3 3 3 3 3 3 3 3 3 1 1 1 1 1 1 1 1 2 1 1 2 2 1 1 1 1 1 23 18 18 18
18 18 18 24 1 1 1 1 1 1 1 1 1 1 1 2 1 1 1 2 1 1 1 1 1 1 1 1 1 1 1 1 1 16 1 2 16 1 1 1 1 3 3 3 3 3 1 1 1 1 1 1 16 2 2 2 2 1 1 1 1 3 3 3 3 3 3 1 1 1 3 3 3 3 3 3 3 3 3 3 3 3 3 3 1 1 1 1 1 1 1 1 2 2 2 2 2 1 1 1 1 1 23 18 18 18
18 18 18 24 1 1 1 1 1 1 1 1 1 1 1 2 1 16 16 2 2 2 2 16 1 1 1 1 1 1 1 1 1 2 2 2 1 1 1 1 3 3 3 3 3 3 3 1 1 1 1 1 1 1 1 1 2 2 2 1 1 1 1 1 1 1 1 1 1 1 1 1 3 1 1 1 1 1 3 3 3 1 1 1 1 1 1 1 1 1 1 1 1 1 2 2 1 1 1 1 1 1 23 18 18 18
18 18 18 24 1 1 1 1 1 1 1 1 2 2 2 1 1 1 1 1 1 1 2 16 16 1 1 1 1 1 1 1 1 2 2 2 1 1 1 1 3 3 3 3 3 3 3 3 1 1 1 1 1 1 1 1 1 2 2 1 1 1 1 1 1 1 1 1 1 1 1 1 1 1 1 1 1 1 1 1 1 1 1 1 1 1 1 1 1 1 16 1 1 2 2 1 1 1 1 1 1 1 23 18 18 18
18 18 18 24 1 1 1 1 1 1 1 1 2 2 2 1 1 1 1 1 1 1 1 1 1 2 1 1 1 1 16 16 1 2 2 1 1 1 1 1 1 1 1 3 3 3 3 3 3 3 1 1 1 1 1 1 1 1 2 2 2 1 1 1 1 1 1 1 1 1 1 1 1 1 1 1 1 1 1 1 1 1 1 1 1 1 1 1 1 1 1 1 2 2 1 1 1 1 1 1 1 1 23 18 18 18
18 18 18 24 1 1 1 1 1 1 1 1 1 1 2 2 2 2 2 2 1 1 2 2 2 2 2 1 1 1 1 1 1 2 1 1 1 1 1 1 1 1 1 1 3 3 3 3 3 3 3 1 1 1 1 1 1 16 16 1 2 2 1 1 1 1 1 1 1 1 1 1 1 1 1 1 1 1 1 1 1 1 1 1 1 1 1 1 2 2 1 1 2 1 1 1 1 1 1 1 1 1 23 18 18 18
18 18 18 24 1 1 1 1 1 1 1 1 1 1 1 1 2 2 2 2 1 2 2 1 1 1 2 2 1 1 1 1 2 1 1 1 1 1 1 1 1 1 1 1 1 1 3 3 3 3 3 3 1 1 1 1 1 1 2 1 1 2 1 2 2 2 2 2 16 16 2 2 2 2 1 2 2 1 1 1 16 16 1 1 2 2 2 2 2 1 1 1 1 1 2 2 16 16 1 1 1 1 23 18 18 18
18 18 18 24 1 1 1 1 1 1 1 1 1 1 1 1 1 1 1 1 2 1 1 1 2 2 1 2 1 1 1 1 2 2 2 16 16 1 1 1 2 2 2 1 1 1 1 3 3 3 3 1 1 1 1 1 1 1 2 1 1 1 1 1 2 2 2 1 1 1 2 2 1 16 2 2 2 2 2 1 1 1 1 2 2 16 1 1 1 1 2 2 1 1 1 1 16 2 1 1 1 1 23 18 18 18
18 18 18 24 1 1 1 1 1 1 1 1 1 1 1 1 1 1 1 1 1 2 2 2 2 1 1 1 2 1 1 1 1 1 2 2 1 1 1 1 1 16 16 1 1 1 1 1 3 3 3 1 1 1 1 1 1 1 2 16 16 1 1 1 1 2 2 2 1 2 2 1 1 1 1 1 1 16 2 2 2 2 2 2 1 16 1 1 1 16 2 2 2 2 1 1 1 1 1 1 1 1 23 18 18 18
18 18 18 24 1 1 1 1 1 1 1 1 1 1 1 1 1 1 1 2 2 2 1 1 1 1 1 1 2 1 1 1 1 1 1 2 2 1 2 2 1 2 2 1 1 1 1 1 1 1 1 1 1 1 1 1 1 2 2 16 16 1 1 1 1 1 1 1 1 2 1 1 1 1 1 1 1 16 16 16 1 1 2 2 2 2 2 1 1 1 2 2 1 1 1 1 1 1 1 1 1 1 23 18 18 18
18 18 18 24 1 1 1 1 1 1 1 1 1 1 1 1 1 1 1 1 1 1 1 1 1 1 1 1 2 1 1 1 1 1 1 1 1 1 1 2 2 1 2 1 1 1 1 1 1 1 1 1 1 1 1 1 2 2 1 1 1 1 1 1 1 16 16 1 1 2 1 2 2 2 2 2 2 2 2 1 1 1 16 1 1 1 1 1 1 1 1 1 1 1 1 1 1 1 1 1 1 1 23 18 18 18
18 18 18 24 1 1 1 1 1 1 1 1 1 1 1 1 1 1 1 1 1 1 1 1 1 1 2 2 2 1 1 1 1 1 1 1 1 1 1 1 2 1 2 2 2 2 2 2 2 1 1 1 1 2 2 2 2 1 1 1 1 1 1 1 1 1 1 1 1 1 1 1 1 2 2 2 2 1 1 1 1 1 1 1 1 1 1 1 1 1 1 1 1 1 1 1 1 1 1 1 1 1 23 18 18 18
18 18 18 24 1 1 1 1 1 1 1 1 1 1 1 2 2 2 1 1 1 1 1 1 1 1 1 1 1 1 1 1 1 1 1 1 1 1 1 1 1 1 1 1 1 1 1 1 1 1 1 1 1 1 1 1 1 1 1 1 1 1 1 1 1 1 1 1 1 1 1 1 1 1 1 1 1 1 1 1 1 1 1 1 1 1 1 1 1 1 1 1 1 1 1 1 1 1 1 1 1 1 23 18 18 18
18 18 18 24 1 1 1 1 1 1 1 1 1 1 1 2 2 1 1 1 1 1 1 1 1 1 1 1 1 1 1 1 1 1 1 1 1 1 1 1 1 1 1 1 1 1 1 1 1 1 1 1 1 1 1 1 1 1 1 1 1 1 1 1 1 1 1 1 1 1 1 1 1 1 1 1 1 1 1 1 1 1 1 1 1 1 1 1 1 1 1 1 1 1 1 1 1 1 1 1 1 1 23 18 18 18
18 18 18 24 1 1 1 1 1 1 1 1 1 1 1 1 1 1 1 1 1 1 1 1 1 1 1 1 1 1 1 1 1 1 1 1 1 1 1 1 1 1 1 1 1 1 1 1 1 1 1 1 1 1 1 1 1 1 1 1 1 1 1 1 1 1 1 1 1 1 1 1 1 1 1 1 1 1 1 1 1 1 1 1 1 1 1 1 1 1 1 1 1 1 1 1 1 1 1 1 1 1 23 18 18 18
18 18 18 30 21 21 21 21 21 21 21 21 21 21 21 21 21 21 21 21 21 21 21 21 21 21 21 21 21 21 21 21 21 21 21 21 21 21 21 21 21 21 21 21 21 21 21 21 21 21 21 21 21 21 21 21 21 21 21 21 21 21 21 21 21 21 21 21 21 21 21 21 21 21 21 21 21 21 21 21 21 21 21 21 21 21 21 21 21 21 21 21 21 21 21 21 21 21 21 21 21 21 31 18 18 18
18 18 18 18 18 18 18 18 18 18 18 18 18 18 18 18 18 18 18 18 18 18 18 18 18 18 18 18 18 18 18 18 18 18 18 18 18 18 18 18 18 18 18 18 18 18 18 18 18 18 18 18 18 18 18 18 18 18 18 18 18 18 18 18 18 18 18 18 18 18 18 18 18 18 18 18 18 18 18 18 18 18 18 18 18 18 18 18 18 18 18 18 18 18 18 18 18 18 18 18 18 18 18 18 18 18
18 18 18 18 18 18 18 18 18 18 18 18 18 18 18 18 18 18 18 18 18 18 18 18 18 18 18 18 18 18 18 18 18 18 18 18 18 18 18 18 18 18 18 18 18 18 18 18 18 18 18 18 18 18 18 18 18 18 18 18 18 18 18 18 18 18 18 18 18 18 18 18 18 18 18 18 18 18 18 18 18 18 18 18 18 18 18 18 18 18 18 18 18 18 18 18 18 18 18 18 18 18 18 18 18 18
18 18 18 18 18 18 18 18 18 18 18 18 18 18 18 18 18 18 18 18 18 18 18 18 18 18 18 18 18 18 18 18 18 18 18 18 18 18 18 18 18 18 18 18 18 18 18 18 18 18 18 18 18 18 18 18 18 18 18 18 18 18 18 18 18 18 18 18 18 18 18 18 18 18 18 18 18 18 18 18 18 18 18 18 18 18 18 18 18 18 18 18 18 18 18 18 18 18 18 18 18 18 18 18 18 18
